20 20
********************
*.....________.....*
*....|.______|.....*
_____||.....||.....*		
______|.....||.....*		
*...........||___..*		
*...........|___|..*			
*...___________||..*		
*..|.___________|..*		
*..||_____.........*		
*..|_____|.........*		
*.......||.........*		
*.......||.........*		
*.......||.........*		
*.._____||.........*		
*.|._____|.........*		
*.||...............*		
*.||________________	
*.|_________________
********************