20 20
********************
________________...*
_______________|...*
*.............||...*		
*.............||...*		
*.............||...*		
*.......______||...*			
*......|.______|...*		
*......||..........*		
*......||..........*		
*......||..........*		
*......||..........*		
*......||..........*		
*......||___________		
*......|____________		
*..................*		
*..................*		
*..................*		
*..................*
********************